111111111111111111111111
10P100000100000000000001
10010000010E000000000001
1000000000000000C0000001
100000000100000000000001
100000010100001010000001
1000001C0000000C00000001
111111111111111111111111
