111111111
10000E001
111111111
1P0C11001
111111111
