1111111111111
10P100C001001
10010000010E1
1000C000C0001
1001000001C11
1000000101001
10C0001C00001
100C000001001
1111111111111
