1111111
10000E1
1010PE1
1000000
1111111
