1111111111111
10P100C001001
10010000010E1
1000C000C0001
1001000001C01
1000000101011
10C0001C00001
1111111111111




