1111111111111
000100C001001
10010000010E1
1000C000C0001
1001000001C01
1000001111001
10C0001C000P1
1111111111111